###########
#@##......#
#..#......#
##..#.....#
###..#....#
####..#...#
#####..#..#
######..#.#
#######...#
########..#
###########